e  e  e  e  e  e  e  e  e  e  e  e  e  e  e  e  e  e  e  e  e  e  e  e  e  e  e  e  e  e  e  e  e  e  e  e  e
e  e  e  e  e  e  e  e  e  e  e  e  e  e  e  e  e  e  e  e  e  e  e  e  e  e  e  e  e  e  e  e  e  e  e  e  e
e  e  sl wr wl wr wl wr wl wr wl wr wl sr e  e  e  e  e  e  sl wl wr wl wr wl wr wl wr wl sr e  e  e  e  e  e
e  e  sl f  f  f  f  f  f  f  f  f  f  sr e  e  e  e  e  e  sl f  f  f  f  f  f  f  f  f  sr e  e  e  e  e  e
e  e  sl f  f  f  f  f  f  f  f  f  f  wr wl wr wl wr wl wr wl f  f  f  f  f  f  f  f  f  sr e  e  e  e  e  e
e  e  sl f  f  f  f  f  f  f  f  f  f  f  f  f  f  f  f  f  f  f  f  f  f  H  f  f  f  f  sr e  e  e  e  e  e
e  e  sl f  f  f  f  f  f  f  f  f  f  f  f  f  f  f  f  f  f  f  f  f  f  f  f  f  f  f  sr e  e  e  e  e  e
e  e  sl f  f  f  f  bw f  f  f  f  f  wr wl wr wl wr wl wr wl f  f  f  f  f  f  f  f  f  sr e  e  e  e  e  e
e  e  sl f  f  f  f  f  f  f  f  f  f  sr e  e  e  e  e  e  sl f  f  f  f  f  f  f  f  f  sr e  e  e  e  e  e
e  e  sl f  f  f  f  f  f  f  f  f  f  sr e  e  e  e  e  e  dl wl wr wl f  f  wr wl wr wl dr e  e  e  e  e  e
e  e  sl f  f  f  f  f  f  f  f  f  f  sr e  e  e  e  e  e  e  e  e  sl f  f  sr e  e  e  e  e  e  e  e  e  e
e  e  sl f  f  f  f  f  f  f  f  f  f  sr e  e  e  e  e  e  e  e  e  sl f  f  sr e  e  e  e  e  e  e  e  e  e
e  e  dl wr wl wr wl f  f  wr wl wr wl dr e  e  e  e  e  e  e  e  e  sl f  f  sr e  e  e  e  e  e  e  e  e  e
e  e  e  e  e  e  sl f  f  sr e  e  e  e  e  e  e  e  e  e  e  e  e  sl f  f  sr e  e  e  e  e  e  e  e  e  e
e  e  e  e  e  e  sl f  f  sr e  e  e  e  e  e  e  e  e  e  e  e  e  sl f  f  sr e  e  e  e  e  e  e  e  e  e
e  e  e  e  e  e  sl f  f  sr e  e  e  e  e  e  e  e  e  e  e  e  e  sl f  f  sr e  e  e  e  e  e  e  e  e  e
e  e  e  e  e  e  sl f  f  sr e  e  e  e  e  e  e  e  sl wl wr wl wr wl f  f  wr wl wr wl wr sr e  e  e  e  e  e
e  e  e  e  e  e  sl f  f  sr e  e  e  e  e  e  e  e  sl f  f  f  f  f  f  f  f  f  f  f  f  sr e  e  e  e  e  e
e  e  e  e  e  e  sl f  f  sr e  e  e  e  e  e  e  e  sl f  f  f  f  f  f  f  f  f  f  f  f  sr e  e  e  e  e  e
e  e  sl wr wl wr wl f  f  wr wl wr wl sr e  e  e  e  sl f  f  f  f  f  f  f  f  f  f  f  f  sr e  e  e  e  e  e
e  e  sl f  f  f  f  f  f  f  f  f  f  sr e  e  e  e  sl f  f  i  f  f  f  f  f  f  f  f  f  sr e  e  e  e  e  e
e  e  sl f  f  f  f  f  f  f  f  f  f  sr e  e  e  e  sl f  f  f  f  f  f  f  f  f  f  f  f  sr e  e  e  e  e  e
e  e  sl f  f  f  f  p1 p2 f  f  f  f  sr e  e  e  e  sl f  f  f  f  f  f  f  f  f  f  i  f  sr e  e  e  e  e  e
e  e  sl f  f  f  f  p4 p3 f  f  f  f  sr e  e  e  e  sl f  f  f  f  f  f  f  f  f  f  f  f  sr e  e  e  e  e  e
e  e  sl f  f  f  f  f  f  f  f  f  f  sr e  e  e  e  sl f  f  f  f  f  f  f  f  f  f  f  f  sr e  e  e  e  e  e
e  e  sl f  f  f  f  f  f  f  f  f  f  sr e  e  e  e  dl wl wr wl wr wl wr wl wr wl wr wl wr dr e  e  e  e  e  e
e  e  sl f  f  f  f  f  f  f  f  f  f  sr e  e  e  e  e  e  e  e  e  e  e  e  e  e  e  e  e  e  e  e  e  e  e
e  e  dl wr wl wr wl wr wl wr wl wr wl dr e  e  e  e  e  e  e  e  e  e  e  e  e  e  e  e  e  e  e  e  e  e  e
e  e  e  e  e  e  e  e  e  e  e  e  e  e  e  e  e  e  e  e  e  e  e  e  e  e  e  e  e  e  e  e  e  e  e  e  e
e  e  e  e  e  e  e  e  e  e  e  e  e  e  e  e  e  e  e  e  e  e  e  e  e  e  e  e  e  e  e  e  e  e  e  e  e
