e  e  e  e  e  e e  e  e  e  e  e  e  e  e  e  e  e
e  e  e  e  e  e  sl wl wr wl wr wl wr wl wr wl sr
e  e  e  e  e  e  sl f  f  f  f  f  f  f  f  f  sr
wl wr wl wr wl wr wl f  f  f  f  f  f  f  f  f  sr
f  f  f  f  f  f  f  f  f  f  f  H  f  f  f  f  sr
f  f  f  f  f  f  f  f  f  f  f  f  f  f  f  f  sr
wl wr wl wr wl wr wl f  f  f  f  f  f  f  f  f  sr
e  e  e  e  e  e  sl f  f  f  f  f  f  f  f  f  sr
e  e  e  e  e  e  dl wl wr wl wr wl wr wl wr wl dr
